########Z#############
#.P#.###.#..##...P#Z.#
#............##.##Z#.#
#..#......##.........#
#.Z#.##...##.##.####.#
###..P#.#P...#P..#....
#Z....#.###..#.....#.#
#####.......P#...#.#P#
#..Z##.#..######Z#..##
#....#.#.##..#P##...Z#
#...................##
#.......#...........P#
#P...#..#Z#..#P##.#.##
######################