#############
##..#.Z.#..##
#...........#
#P.........Z#
##Z.#########
##..#########
##.......P###
##..Z#.##.###
##...#.##.###
##.###....###
##.....######
##.##.Z.#####
##.##....P###
##.###.##.###
#...........#
#...........#
#..#Z....#..#
#......P....#
#############