..................
.....########P....
..Z############...
..##############P.
..##############Z.
.#####.####.#####.
.####........####.
.####.P.P.P..####.
.###..........###.
.####........####.
.####...Z...Z####.
.#####....P.#####.
.#######..#######.
..##..##P.######..
...##.....#####...
.ZP.####Z.####....
.....###.Z###Z....
..................