##########
#P..Z...P#
#.##.###.#
#.#.P###.#
#Z#.####.#
#.#.###.Z#
#.#.###.##
#P.Z...P##
##########