#Z#################
#.#....Z.........P#
#.#.###.#.#########
#...#...#...Z.....#
#.###.#########.#.#
#.#P..#.......#P#.#
#.#####.#####.###.#
#...#..Z....#.#...#
###.#.#####.#.#.#.#
#P..#.#...#.#.#.#.#
###.#.#.#Z#.#.#.#.#
#...#...#.#.#..Z#P#
#.#######P#########
#.......#.#.......#
#####.#.#.#.#####Z#
#..P#.#.#...#...#.#
#.###.#.#####.#.#.#
#.....#...Z...#P#..
###################