#Z.......#.......Z#
#.##.###.#.###.##.#
#.................#
#.##.#.#####.#.##.#
#P...#Z..#..Z#...P#
####.###.#.###.####
####.#P.....P#.####
####.#.##.##.#.####
Z......#Z.P#......Z
####.#.#####.#.####
####.#P.....P#.####
####.###.#.###.####
#P.......#.......P#
#.##.###.#.###.##.#
#..#...........#..#
##.#.#.#####.#.#.##
#P...#Z..#..Z#...P#
#.######.#.######.#
#Z.......P.......Z#